0,0,0,0,0,0,0,0,0,0,0,0,0,0,0,0,0,0,0,0,0,0,0,0,0,0,0,0,0,0,0,0,0,0,0,0,0,0,0,0,0,0,0,0,0,0
0,0,0,0,0,0,0,0,0,0,0,0,0,0,0,0,0,0,0,0,0,0,0,0,0,0,0,0,0,0,0,0,0,0,0,0,0,0,0,0,0,0,0,0,0,0
0,0,0,0,0,0,0,0,0,0,0,0,0,0,0,0,0,0,0,0,0,0,0,0,0,0,0,0,0,0,0,0,0,0,1,1,0,0,0,0,0,0,0,0,0,0
0,0,0,0,0,0,0,0,0,0,0,0,0,0,0,0,0,0,0,0,0,0,0,0,0,0,0,0,0,0,0,0,0,0,2,2,0,0,0,0,0,0,0,0,0,0
0,0,0,0,0,0,0,0,0,0,0,0,0,0,0,0,0,0,0,0,0,0,0,0,0,0,0,0,0,0,0,0,0,0,2,2,0,0,0,0,0,0,0,0,0,0
0,0,0,0,0,0,0,0,0,0,0,0,0,0,0,0,0,0,0,0,0,0,0,0,0,0,0,0,0,0,0,0,0,0,2,2,0,0,0,0,0,0,0,0,0,0
0,0,0,0,0,0,0,0,0,0,0,0,0,0,0,0,0,0,0,0,0,0,0,0,0,0,0,0,0,0,0,0,0,0,2,2,0,0,0,0,0,0,0,0,0,0
0,0,0,0,0,0,0,0,0,0,0,0,0,0,0,0,0,0,0,0,0,0,0,0,0,0,0,0,0,0,0,0,0,0,2,2,1,0,0,0,0,0,0,0,0,0
0,0,0,0,0,0,0,0,0,0,0,0,0,0,0,0,0,0,0,0,0,0,1,1,0,1,0,0,1,1,0,0,0,0,2,2,2,0,0,0,0,0,0,0,10,0
0,6,0,0,0,0,0,0,0,0,0,0,0,0,0,0,0,0,0,0,0,0,2,2,0,2,0,0,2,2,0,0,0,0,2,2,2,0,0,0,0,0,0,0,1,1
0,3,0,0,0,0,0,1,1,0,0,0,0,0,0,0,0,1,1,1,0,0,2,2,0,2,0,0,2,2,0,0,0,0,2,2,2,0,0,0,0,0,0,0,2,2
0,0,0,0,0,0,1,2,2,0,0,0,0,0,0,0,0,2,2,2,0,0,2,2,0,2,0,0,2,2,0,0,0,0,2,2,2,0,0,0,0,0,0,0,2,2
0,0,8,9,0,1,2,2,2,0,0,0,0,1,0,0,0,0,0,0,0,0,2,2,0,2,0,0,2,2,1,1,1,1,2,2,2,0,0,0,0,0,0,0,2,2
0,7,4,5,1,2,2,2,2,0,0,0,1,2,0,0,0,0,0,0,0,0,2,2,0,2,0,0,2,2,2,2,2,2,2,2,2,1,0,0,1,1,1,1,2,2
2,2,2,2,2,2,2,2,2,0,1,1,2,2,3,1,1,1,1,1,1,1,2,2,0,2,2,2,2,2,2,2,2,2,2,2,2,2,0,0,2,2,2,2,2,2
2,2,2,2,2,2,2,2,2,0,2,2,2,2,2,2,2,2,2,2,2,2,2,2,0,2,2,2,2,2,2,2,2,2,2,2,2,2,0,0,2,2,2,2,2,2